NO ./textures/wall1.xpm
SO ./textures/wall2.xpm
WE ./textures/wall3.xpm
EA ./textures/wall4.xpm

F 25,25,25
C 180,40,40

111111111111111
100000000000001
101111111111101
101000000000101
101011111110101
101010000010101
101010W00010101
101011101110101
101000000000101
101111111111101
100000000000001
111111111111111