NO ./textures/wall1.xpm
SO ./textures/wall2.xpm
WE ./textures/wall3.xpm
EA ./textures/wall4.xpm

F 0,128,0
C 135,206,235

  111111
 11000011
1100000011
1000S00001
1100000011
 11000011
  111111