NO ./textures/wall3.xpm
SO ./textures/wall2.xpm
WE ./textures/wall1.xpm
EA ./textures/wall4.xpm
F 0,0,0
C 255,255,255

11111111111111111
10000000000000001
10000000000000001
10000011100000001
1000001S100000001
10000011100000001
10000000000000001
10000000000000001
11111111111111111
