F 0,0,0


WE ./textures/wall1.xpm
C 255,255,255
EA ./textures/wall4.xpm

NO ./textures/wall3.xpm
SO ./textures/wall2.xpm

1111111
1000001
100E001
1000001
1111111
