NO ./textures/wall1.xpm
SO ./textures/wall2.xpm
WE ./textures/wall3.xpm
EA ./textures/wall4.xpm

F 50,50,50
C 100,150,200

1111111
1000001
100E001
1000001
1111111